SO                                            ./asset/bluestone.xpm

WE                                        ./asset/colorstone.xpm

EA  ./asset/eagle.xpm





NO  ./asset/redbrick.xpm
C   0,+0000000159,247
F   24,100,171


111111111111111111111111111111111111
100000000000000000000000000000000001
100000000000000000000000000000000001
100000000000000000000000000000000001
100000000000000000000000000000000001
100000000000000000000000000000000001
1000000000000000000000W0000000000001
100000000000000000000000000000000001
100000000000000000000000000000000001
100000000000000000000000000000000001
100000000000000000000000000000000001
111111111111111111111000000000000001
100000000001000111111111111111111111
1000000000010001111111111111111111111
1000000000010001111111111111111111111
1111111111111111111111111111111111111
111111111111111111111111111111111111
