

SO ./asset/bluestone.xpm
WE  ./asset/colorstone.xpm
EA  ./asset/eagle.xpm

NO  ./asset/redbrick.xpm
C   128,127,255
F   200,100,157


1111111
1000101
1100001
1000001
110N001
1111111

111111111111111111111111111111111111
 100000000000000000000000000000000001
 100000000000000000000000000000000001
 100000000000000000000000000000000001
 100000000000000000001000000000000001
 100000000000000010000000000000000001
 100000000000010000000000000000000001
 10000000001110000100000000000000001
 10000000001100000000000000000000001
 100000000011100000000000001000000001
 1111111111111111111110000000000000011111111111111111
 100000000001000111111111111111111111111111111111111
 100000000001000111111111111111111111111111111111111
 100000000001000111111111111111111111111111111111111
 100000000001000111111111111111111111111111111111111
 11111111111111111111111111111111111111
 111111111111111111111111111111111111

